{
    "level": [
        "0000000000",
        "0000000000",
        "1P00ED0000",
        "1111101000",
        "D0E0001000",
        "0F00000000"
    ]
}