{
    "level": [
        "00000000000",
        "00000000000",
        "1P00ED000D0",
        "11111010000",
        "00000010S00",
        "0100U00A00D",
        "01111111111",
        "0111E110110",
        "00E0T0EU00F"
    ]
}