{
    "level": [
        "0000000000",
        "0000000000",
        "1P00ED000D",
        "11111010T0",
        "D0E00010S0",
        "F000U00A0T"
    ]
}